#############
#..#........#
#..#........#
#..#..#..#..#
#..#..#..#..#
#..#..#..#..#
#..####..#..#
#...........#
#...........#
#############
